11111111
1C0P10C1
10C0C001
111C01C1
1C0E0101
10C001C1
11111111