11111
100C1
1CP11
10C01
10101
1E111
11111