11111111
10000001
10000001
100C0101
100E0101
100P0101
11111111